........#...#.............#
........#####....#######..#
####......................#
............######..#.....#
....#####...........#.....#
....#...............#.....#
....#...............#.....#
....#...#...........#######
....#...#.................#
....#...#.................#
....#....#.....########...#
#####....#.....#......#...#
.........##....#......#...#
........####......#########
.......#...#..............#
...#####...####......######
...#...#......#......#....#
...#...#......########....#
...#...#.............#....#
...#.......#..............#
...#.......#...###........#
...#...#...#...###...#....#
...#...#...#.........#....#
...#####...###########....#
.....................#....
.....................#....