....#.....................#
....#.....................#
....#.....................#
....#...#########...#.....#
....................#.....#
....................#.....#
....#...............#.....#
....#...##############...##
....#...#.................#
....#...#.................#
....#....#.....########...#
#...#....#.....#......#...#
....#....##....#......#...#
...#.....###.......########
...#.......#..............#
...####....####......######
...#...#...#..#......#....#
...#...#......##...###....#
...#...#.......#.....#....#
...#.......#...#..........#
...#.......#...###........#
...#...#...#...###...#....#
...#...#...#...#.....#....#
...#####...###########....#
...........#...............
...........#...............