..........................#
..........................#
#######################...#
..........................#
..........................#
...########################
..........................#
..........................#
#######################...#
..........................#
..........................#
...########################
..........................#
..........................#
#######################...#
..........................#
..........................#
...########################
..........................#
..........................#
#######################...#
..........................#
..........................#
...########################
..........................
..........................